|-----------------------------|
|O                           O|
|                             |
|                             |
|                             |
|                             |
|                             |
|                             |
|                             |
|                             |
|                             |
|-----------------------------|