|-----------------------------|
|o                            |
|                             |
|                             |
|                             |
|                             |
|                             |
|                             |
|                             |
|                             |
|                             |
|-----------------------------|